ъ - в
ш - к
г - г
л - о
с - д
х - у
а - н
и - п
з - м
ч - а
н - б
ц - ы
о - л
й - и
в - р
ь - з
п - ч
р - ф
ы - т
ж - ш
ю - с
д - е
я - ь
э - й
т - ъ
б - ц
е - ж
к - э
м - ё
у - ю
ф - й
щ - щ
ё - я
